17 17	
# # # # # # # # # # # # # . # # #	
# . . . . . . . . . . . # . # . #	
# # # # # . # # # # # # # . # . #	
# . . . . . # . . . . . . . # . #	
# . # # # # # . # # # # # # # . #	
# . # . . . . . # . . . # . . . #	
# . # . # # # # # . # . # . # . #	
# . # . . . . . . . # . # . # . #	
# . # # # # # # # . # # # . # . #	
# . . . # . . . # . . . . . # . #	
# . # . # . # . # # # # # . # . #	
# . # . . . # . # . # . . . # . #	
# # # # # # # . # . # . # . # # #	
# . . . . . # . # . . . # . . . #	
# . # # # . # . # . # # # . # . #	
# . . . # . . . . . # . . . # . #	
# # # # # # # # # # # # # # # . #