25 15
# # # # # # # # # # # # # # # # # # # # T # # # # 
# t # ! . n # r e h t i e . s o u t # e h e r e # 
# u # # # o # # # e # # # e # # # h # . # # # . # 
# b . e v i t c # r . t # b . d # . # p a t # i # 
# # # # # # # e # # # h # # # l # # # # # h # s # 
# h a p # d i r # # # i s . # u o c . h t . # . # 
# r # s # . # # # # # # # w # # # # # r # # # a # 
# e # . # r e h t o n a # a # . h g u o # o # . # 
# p # n # # # # # # # . # # # m # # # # # n # w # 
# . # o t . # s i . # s d e # a # e r e # . y a # 
# t # # # t # . # o # # # e # z # h # # # t # # # 
# u # s i h # x # w t . # n . e # . o g . o # . # 
# b # # # # # # # o # r # u # # # # # e # # # t # 
# . s i h t . s i . # e b m # t u o . t . l o s # 
# . # # # # # # # # # # # # # # # # # # # # # # # 